0TD	Тканинні килимки спереду і позаду
3T2	Сидіння з оптимізованими підголівниками для захисту голови спереду, 3-и підголівники позаду
4A3	Підігрів передніх сидінь
4L1	Внутрішнє дзеркало - механічне, з підключенням до датчика вологості
5KC	Задні сидіння розділені, та складаются з центральним підлокітником з тримачем чашок
5XH	Сонцезахисні козирки з Make-Up дзеркалом та LED підсвічуванням 
6E3	Підлокітник спереду з відділенням для зберігання "JUMBO BOX"
6T2	Освітлення простору для ніг спереду та позаду
7E6	Додатковий електрообігрів повітря салону (тільки для дизеля)
7X1	Задній парктронік "PARK DISTANCE CONTROL" 
8T6	Круїз-контроль з обмежувачем швидкості "CRUISE CONTROL"
8S4	2 лампи для читання спереду, 2 лампи ззаду
9JC	Пакет курця (прикурювач, попільнички спереду)
9T1	Підігрів форсунок омивача лобового скла
9P3	Попереджувальний сигнал ременя безпеки у водія та пасажира
9S6	Бортовий комп'ютер кольоровий "MAXI DOT"
9ZX	Підготовка до мобільного телефону (тільки Bluetooth)
PF0	Пакет "Погані дороги" (додатковий захист двигуна, захист від каменів)
PHA	Двозонна система кондиціювання з сенсорами вологи та сонця "CLIMATRONIC"
PJ1	Легкосплавні диски "MITYKAS" 7Jx17" - 4 шт.
PJI	Легкосплавні диски "MITYKAS" 7Jx17 ", включаючи шини з супер-оптимізацією опору коченню
PJA	Запасне колесо (тимчасове) зі сталевим диском
PK1	Сидіння водія та переднього пасажира з поперековою підтримкою 
7K9	Система контролю тиску в шинах (RKA+ дисплей контролю шин)
PW0	Зовнішні дзеркала заднього огляду, що складаються, з електрорегулюванням та обігрівом
QN3	Шухляди під сидіннями спереду (Sportline - сидіння водія)
YOY	Remote Access + Online Infotainment 1 рік
YO2	Віддалений доступ Remote Access 1 рік
RA1	8 динаміків
0TR	Тканинні килимки "LOUNGE STEP" спереду і позаду
1M5	Підготовка до фаркопа
1M6	Фаркоп, що обертається 
1U9	Складаний столик на спинках передніх сидінь
3CX	Змінна сітчаста перегородка
3G2	Підготовка до кріплення дитячого сидіння "ISOFIX" на передньому пасажирському сидінні
3H2	Сидіння пасажира спереду зі спинкою, що складається
3Z4	Кошик для сміття
3X5	Знімний мішок "UNIBAG"
3Y4	Механічна шторка від сонця на задніх бічних вікнах
3ZU	Триточковий ремінь безпеки позаду
4A4	Передні та задні сидіння з підігрівом 
4E7	Електричне відкриття і закриття кришки багажника
4KF	Затемненням задніх бокових та заднього вікна "SUNSET"
4L5	Внутрішнє дзеркало заднього виду з автоматичним затемненням, з USB
6K2	"FRONT ASSIST" - Система попередження зіткнень, включаючи аварійне гальмування без адаптивного круїз-контролю
6SJ	Двосторонній килимок у багажному відділенні
7M3	Декоративні дверні пороги спереду
7W1	Проактивний захист водія і переднього пасажира "CREW PROTECT ASSIST"
7W2	Проактивний захист водія і переднього пасажира з розширеною системою безпеки "CREW PROTECT ASSIST" Pre-Crash (базовий та спереду)
7X2	Задній та передній парктронік "PARK DISTANCE CONTROL"
8QG	3 ключі
9P5	Попереджувальний світловий сигнал про непристебнутий ремінь безпеки (для всіх пасажирів)
9S0	Цифрова панель приладів
EM1	Система розпізнання втоми водія "DRIVER ALERT"
IA1	Тримач для планшета (2шт.)
N0Q	Оббивка сидінь - шкіра з перфорацією
P0S	Телескопічні омивачі передніх фар
PB0	Електрорегулювання сидіння водія, з функцією запам'ятовування та підтримкою поперекової зони
PB2	Електрорегулювання сидіння водія та пасажира, з функцією запам'ятовування та підтримкою поперекової зони (без шухляд під сидіннями)
PB3	Електрорегулювані сидіння водія та пасажира, з функцією запам'ятовування,регулюванням глибини подушки та вентиляцією - зі шкіряною оббивкою (без шухляди)
PB4	Електрорегульовані передні сидіння Ergo з функцією запам'ятовування, регулюванням глибини подушки та вентиляцією, з поперековою опорою з функцією масажу, зі шкіряною оббивкою (без шухляди)
PDB	Система безключового пуску двигуна "Kessy GO" з сигналізацією та SAFE системою
PDD	Система безключового доступу та пуску двигуна "Kessy Full" з сигналізацією та SAFE систмою
PDE	Система безключового доступу та пуску двигуна "Kessy Full"
PE0	Подушка безпеки захисту колін водія, подушка безпеки пасажира (з деактивацією)
PE1	Захисні шторки безпеки, бокові подушки спереду
PE2	Подушки безпеки захисту голови, бокові подушки безпеки спереду та позаду
PF2	Вибір режимів руху "DRIVING MODE SELECT"
PF3	Вибір режиму водіння з функцією OFF ROAD "DRIVING MODE SELECT" 4х4 (+Асистент рушання вгору / контроль спуску з пагорба)
PF4	Адаптивне управління шасі DCC (4x4 з Off-Road кнопкою)
PG1	Пакет Chrome (яскраві рейлінги, яскраві декоративні елементи)
PH1	Розсувний панорамний дах
PHB	Тризонний клімат-контроль 
PHD	Передні сидіння з вентиляцією, шкіряна оббивка сидінь
PJ3	Легкосплавні диски "ELBRUS" 7Jx18"
PJF	Сталеві диски 6.5J x 17
PJN	Легкосплавні диски "ELBRUS" 7Jx18" з всесезонними шинами
PJR	Легкосплавні диски "IGNITE" 8.5Jx20 ", з активним моніторингом тиску в шинах
PJS	Легкосплавні диски "VEGA" 8Jx20 ", з активним моніторингом тиску в шинах
PJV	Легкосплавні диски "PROCYON" 7Jx19 "+ ковпаки Aero чорні матові
PJW	Легкосплавні диски "PROCYON" 7Jx19 "+ ковпаки Aero чорні
PJX	Легкосплавні диски "PROCYON" 7Jx19 "+ ковпаки Aero антрацитові
PJ4	Легкосплавні диски "TRINITY" 7Jx18" глянець
PJ5	Легкосплавні диски "TRIGLAV" 7Jx19" глянець
PJ7	Легкосплавні диски "TRIGLAV" 7Jx19" глянець, чорний
PJ8	Легкосплавні диски "TRINITY" 7Jx18" глянцевий антрацит
PJ9	Легкосплавні диски "CRATER" 7Jx19" глянець, чорний
PJT	Легкосплавні диски CURSA" 7,5Jx19" - антрацит
PJC	Легкосплавне запасне колесо
PJD	Сталеве запасне неповнорозмірне колесо
PJE	Сталеве запасне неповнорозмірне колесо для 7 місць
PJP	Легкосплавні диски "ASKELLA" 7,5x18 "- яскрава механічна антрацитова обробка 
PJU	Легкосплавні диски "MEROPE" 8Jx20 "- яскрава механічна антрацитова обробка, включаючи активний контроль тиску в шинах
PK0	Фаркоп з адаптером, що знімається
PK9	Віртуальна педаль (відкриття багажного відділення, з сенсорним керуванням)
PKA	Набір сіток "Net program" + cargoelements
PKB	Сітки в багажнику (1 горизонтальна, 2 вертикальні)+відділення для для зберігання з кришкою в багажнику+освітлення)
PKV	Вітрове скло з обігрівом + датчик дощу
PKP	Змінюване днище багажника
PL1	Оббивка сидінь - шкіра
PL4	Оббивка сидінь - Suedia 
PL5	Оббивка - ECO Package
PLC	2-и спицеве багатофункціональне шкіряне кермо для радіо і телефона, з пелюстками перемикання передач
PLD	2-и спицеве багатофункціональне шкіряне кермо, з підігрівом
PLK	3-и спицеве багатофункціональне спортивне шкіряне кермо, з підігрівом, з пелюстками перемикання передач для DSG
PLE	2-и спицеве багатофункціональне шкіряне кермо, з підігрівом та пелюстками перемикання передач
PLF	3-х спицеве багатофункціональне шкіряне спортивне кермо 
PLG	3-и спицеве шкіряне спортивне багатофункціональне кермо, з пелюстками перемикання передач
PLH	3-х спицеве багатофункціональне шкіряне спортивне кермо з підігрівом
PLJ	Адаптивний круїз-контроль до 210 км/год "FRONT ASSIST"
PN2	LED освітлення салону "LED PACKAGE PLUS" Ambient Lighting
PN4	Асистент керування світлом фар "LIGHT ASSIST" ("COMMING HOME","LEAVING HOME","TUNNEL LIGHT", "DAY LIGHT") + Датчик дощу
PN5	Повністю світлодіодні матричні фари з функцією повороту (Full LED Matrix з AFS, з AWL та функцією повороту,ефект привітання, мультифункціональна камера)
7X5	Паркувальний асистент "PARK ASSIST"
8A9	Асистент паркування PARK ASSIST + TRAILER ASSIST
8A8	PARK DISTANCE CONTROL - датчики паркування спереду та ззаду + TRAILER ASSIST + Area View,  LED SBBR High
PRF	Внутрішнє дзеркало з функцією автоматичного затемнення на боці водія та датчиком дощу, Light Assist
PT6	Комфортна телефонія із зарядним пристроєм без підключення до зовнішньої антени
PW1	Зовнішні дзеркала заднього огляду з автозатемненням на боці водія, що складаються, з електрорегулюванням та обігрівом, внутрішнє дзеркало з автозатемненням, датчик дощу з 'LIGHT ASSIST"
PW2	Зовнішні дзеркала заднього огляду з автозатемненням на боці водія, що складаються, з електрорегулюванням та обігрівом, функцією пам'яті. Дзеркало заднього огляду з автозатемненням, датчиком дощу та 'LIGHT ASSIST"
PWB	Асистент зміни полоси руху SIDE ASSIST (з заднім радаром Rear Traffic Alert)
PWE	Асистент автоматичного керування дальнім світлом фар із автозатемненням внутрішнього дзеркала та датчиком дощу з "LIGHT ASSIST" ("COMMING HOME","LEAVING HOME","TUNNEL LIGHT", "DAY LIGHT")
PWF	Камера заднього огляду "REAR VIEW CAMERA MID"
PWG	Система кругового огляду "Area View"
PXB	Пакет "Sleep package" (тканинні килимки килимки спереду і позаду, підголівники позаду,бічні вікна з теплоізоляційного скла, від B-pillar та заднього вікна скло тоноване)
PXE	Пакет "Sleep package" II (SUNSET + акустичні вікна спереду,тканинні килимки спереду і позаду, підголівники позаду, боковий сонцезахисний козирок позаду - механічний)
PXD	Пакет "Прогресивне керування" 
PXC	Сімейний пакет
PZB	Третій ряд сидінь, підлокітники попереду та у другому ряду, подвійна підлога в багажному відділенні, попереджувальне світло Econtrol пасажирського ременя безпеки
QV3	Прийом цифрового радіо "DAB"
RA2	Звукова система "CANTON", 10 динаміків, центральний динамік, сабвуфер
RA3	USB спереду та позаду, розетка 230 V позаду
RNA	Інформаційне радіо "BOLERO": 8,0'' ємнісний сенсорний кольоровий дисплей голосове керування, WLAN, Smart Link (бездротовий для Apple), 2x USB-C спереду
RNC	Інформаційна навігаційна система "AMUNDSEN": 8,0'' ємнісний сенсорний кольоровий дисплей голосове керування, WLAN, Smart Link (бездротовий для Apple),  2x USB-C спереду
RND	Навігаційна система "AMUNDSEN": 8,0'' ємнісний сенсорний кольоровий дисплей голосове керування, WLAN, Web Radio + "SMARTLINK" (бездротовий для Apple)
RNE	Навігаційна система "COLUMBUS", голосове керування, WLAN + "SMARTLINK" (бездротовий для Apple)
RNF	Навігаційна система "COLUMBUS": 9,2'' ємнісний сенсорний кольоровий дисплей голосове керування, WLAN, Web Radio + "SMARTLINK" бездротовий для Apple)
UG1	Система утримання автомобіля на схилі
UK3	Відкидні спинки сидінь другого ряду з доступом з багажного простору
VF1	Педалі нержавіюча сталь
VW5	Акустичні передні бічні вікна із SunSet
VW6	Акустичні передні бічні вікна без SunSet
WVK	Пакет Ambition Business and View LOW
WVL	Пакет Ambition Business and View High
WVA	Пакет Ambition Comfort and Function Low
WVB	Пакет Ambition Comfort and Function High
WVG	Пакет Safety and Drive LOW
WVH	Пакет Safety and Drive High 
WVM	Пакет Style Business and View
WVD	Пакет Style Comfort and Function High
WVC	Пакет Style Comfort and Function  Low
WVE	Пакет L&K Comfort and Function
WVI	Пакет L&K Safety and Dríive
WVJ	Пакет SportLine Safety and Drive
WVF	Пакет SportLine Comfort and Function
EA7	Подовження гарантії 4 роки/90 000 км
EA2	Подовження гарантії 4 роки/120 000 км
UNI	Не металік (K4K4)
SPE	Спецлак (M3M3)
MET	Mеталік
FLT	Спецметалік (K1K1)
